NO ./spt/north_tree.xpm
SO ./spt/south_tree.xpm
WE ./spt/west_tree.xpm
EA ./spt/east_tree.xpm

C 0,0,55
F 255,0,0

     1      
11111011    
10000N001   
11111011    
1111101     
1111101     
1111101     
1111101     
1111101     
1111101     
1111101     
1111111  
