NO ./spt/north_tex.xpm
SO ./spt/south_tex.xpm
WE ./spt/west_tex.xpm
EA ./spt/east_tex.xpm

C 234,100,55
F 255,10,47

11111111
11111011
10000W001
11111011
1111101
1111101                       
1011101
1111101
1111101
1111101
1111101
1111111
