NO /nfs/homes/btani/Desktop/42-cub3d/spt/north_tree.xpm
SO /nfs/homes/btani/Desktop/42-cub3d/spt/south_tree.xpm
WE /nfs/homes/btani/Desktop/42-cub3d/spt/west_tree.xpm
EA /nfs/homes/btani/Desktop/42-cub3d/spt/east_tree.xpm

F 255,255,100
C 0,0,255

1111111
1000001
100S001
1000001
1111111
