NO spt/north_tree.xpm
SO spt/south_tree.xpm
WE spt/west_tree.xpm
EA spt/east_tree.xpm

F 255,255,100
C 0,0,255

1111111
1000001
1000N01
1000001
1111111
