NO ./spt/north_tree.xpm
SO ./spt/south_tree.xpm
WE ./spt/west_tree.xpm
EA ./spt/east_tree.xpm

F 108,200,162
C 225,202,255




1111111
1000001
100N001
1000001
1111111
