NO ./spt/north_tex.xpm
SO ./spt/south_tex.xpm
WE ./spt/west_tex.xpm
EA ./spt/east_tex.xpm

C 92,148,252
F 200,76,12

111111111111
100000000001
100000000001
10000N000001
100000000001
1000000 0001
100000000001
111111111111
